R  960	960
NO ./texture/wall/wall_chinese_n.xpm
SO ./texture/wall/wall_chinese_s.xpm
WE ./texture/wall/wall_chinese_w.xpm
EA ./texture/wall/wall_chinese_e.xpm

S ./texture/sprite/coin.xpm

F 124,252,0
C 135,206,235

111011111111111111111111111111
100000000000001100000000000001
100000000000001100000000000000
100000000000001100000000000001
100020000000000000000000000001
100000000000000000000020000001
100000000020000000000000000001
10000000000000W000000000000001
100000000000000000000000000001
100002000000000000000200000001
100000000000000000000000000000
100000000000000200000000000001
111111111111111111111111111111