R  960	960
NO ./texture/wall/wall_chinese_n.xpm
SO ./texture/wall/wall_chinese_s.xpm
WE ./texture/wall/wall_chinese_w.xpm
EA ./texture/wall/wall_chinese_e.xpm

S ./texture/sprite/coin.xpm

F 124,252,0
C 135,206,235

11111111111111111111111111111
11111111110000000011111111111
11111111000000000000111111111
11111100020000002000000011111
11110000000000000000000001111
11000000000000000000200000011
10000000200000000000000000001
1100000000000W000000000000011
11110000000000000000200001111
11111100000002000000000111111
11111111000000000000011111111
11111111110000000001111111111
11111111111111111111111111111