R  960	960
NO ./texture/wall/wall_chinese_n.xpm
SO ./texture/wall/wall_chinese_s.xpm
WE ./texture/wall/wall_chinese_w.xpm
EA ./texture/wall/wall_chinese_e.xpm

S ./texture/sprite/coin.xpm

F 124,252,0
C 135,206,235

111111111111111111111111111111
100000000000000000000000000001
100000000011111111111100000001
100000000000000000000000000001
100010000000000000001111100001
100010000000000000000000000001
100000000000000000000000000001
100001000000000W00001000000001
100001100000000000001100000001
100001110000000000001100000001
100000000001011000000100000001
100000000000000000000100000001
111111111111111111111111111111