R  960	960
NO ./texture/wall/wall_chinese_n.xpm
SO ./texture/wall/wall_chinese_s.xpm
WE ./texture/wall/wall_chinese_w.xpm
EA ./texture/wall/wall_chinese_e.xpm

S ./texture/sprite/coin.xpm

F 124,252,0
C 135,206,235

111111111111111111111111111111
100000002222222200000000000001
100000000000000000000000000001
100002000200020020200202020021
100000000000000000000000000001
100020002000020000200020000201
100000000000000000000000020001
10000000000000W000000000002001
100020000000000000000000000001
100020000000000022220000000001
100020000000000022220000000001
100020000000000000000000000001
111111111111111111111111111111