R  960	960
NO ./texture/wall/wall_chinese_n.xpm
SO ./texture/wall/wall_chinese_s.xpm
WE ./texture/wall/wall_chinese_w.xpm
EA ./texture/wall/wall_chinese_e.xpm

S ./texture/sprite/coin.xpm

F 124,252,0
C 135,206,235

111111111111111111111111111111
100000000000000000000000000001
100000000000000000000000000001
100000011000110000111111100001
100000110000110001100001110001
100001100000110000000001100001
100011000000110000000011000001
100111111111110000000110W00001
100000000000110000001100000001
100000000000110000111000000001
100000000000110001111111100001
100000000000000000000000000001
111111111111111111111111111111