R  960	960
NO ./texture/wall/wall_chinese_n.xpm
SO ./texture/wall/wall_chinese_s.xpm
WE ./texture/wall/wall_chinese_w.xpm
EA ./texture/wall/wall_chinese_e.xpm

S ./texture/sprite/coin.xpm

F 124,252,0
C 135,206,235

111111111111111111111111111111
100000000000000000000000000001
100111111111111111111111111111
100000000000000000000000000001
111111111111111111111111111001
100000000000200000000000000001
100111111111111111111111111111
100000200000000W00000000000001
111111111111111111111111111001
100002000000000000000200000001
100111111111111111111111111111
100000000000000200000000000001
111111111111111111111111111111